0 1 0 T 0 0 1 0 G A
P 1 0 0 1 O N 0 1 0
0 1 Y 0 1 0 0 0 0 M
0 0 0 1 0 0 0 X 1 E
1 0 0 1 H 0 1 0 1 0